./Wikipedia_disambiguation/Wikipedia_disambiguation0.txt	./Wikipedia_disambiguation/$0.txt
./Wikipedia_disambiguation/Wikipedia_disambiguation1.txt	./Wikipedia_disambiguation/$1000.txt
./Wikipedia_disambiguation/Wikipedia_disambiguation2.txt	./Wikipedia_disambiguation/$100.txt
./Wikipedia_disambiguation/Wikipedia_disambiguation3.txt	./Wikipedia_disambiguation/$10.txt
./Wikipedia_disambiguation/Wikipedia_disambiguation4.txt	./Wikipedia_disambiguation/$1 coin.txt
./Wikipedia_disambiguation/Wikipedia_disambiguation5.txt	./Wikipedia_disambiguation/$1.txt
./Wikipedia_disambiguation/Wikipedia_disambiguation6.txt	./Wikipedia_disambiguation/$200.txt
./Wikipedia_disambiguation/Wikipedia_disambiguation7.txt	./Wikipedia_disambiguation/$20.txt
./Wikipedia_disambiguation/Wikipedia_disambiguation8.txt	./Wikipedia_disambiguation/$2.txt
./Wikipedia_disambiguation/Wikipedia_disambiguation9.txt	./Wikipedia_disambiguation/$3.txt
./Wikipedia_disambiguation/Wikipedia_disambiguation10.txt	./Wikipedia_disambiguation/$500.txt
./Wikipedia_disambiguation/Wikipedia_disambiguation11.txt	./Wikipedia_disambiguation/$50.txt
./Wikipedia_disambiguation/Wikipedia_disambiguation12.txt	./Wikipedia_disambiguation/$5.txt
./Wikipedia_disambiguation/Wikipedia_disambiguation13.txt	./Wikipedia_disambiguation/$ (disambiguation).txt
./Wikipedia_disambiguation/Wikipedia_disambiguation14.txt	./Wikipedia_disambiguation/£$€.txt
./Wikipedia_disambiguation/Wikipedia_disambiguation15.txt	./Wikipedia_disambiguation/£2.txt
./Wikipedia_disambiguation/Wikipedia_disambiguation16.txt	./Wikipedia_disambiguation/₰.txt
./Wikipedia_disambiguation/Wikipedia_disambiguation17.txt	./Wikipedia_disambiguation/03 numbers.txt
./Wikipedia_disambiguation/Wikipedia_disambiguation18.txt	./Wikipedia_disambiguation/0.99.txt
./Wikipedia_disambiguation/Wikipedia_disambiguation19.txt	./Wikipedia_disambiguation/0 series.txt
./Wikipedia_disambiguation/Wikipedia_disambiguation20.txt	./Wikipedia_disambiguation/0 to 100.txt
./Wikipedia_disambiguation/Wikipedia_disambiguation21.txt	./Wikipedia_disambiguation/10,000 Buddhas.txt
./Wikipedia_disambiguation/Wikipedia_disambiguation22.txt	./Wikipedia_disambiguation/10,000 Days.txt
./Wikipedia_disambiguation/Wikipedia_disambiguation23.txt	./Wikipedia_disambiguation/10,000 Hours (disambiguation).txt
./Wikipedia_disambiguation/Wikipedia_disambiguation24.txt	./Wikipedia_disambiguation/10,000 Reasons.txt
./Wikipedia_disambiguation/Wikipedia_disambiguation25.txt	./Wikipedia_disambiguation/10-20 system.txt
./Wikipedia_disambiguation/Wikipedia_disambiguation26.txt	./Wikipedia_disambiguation/10 Años.txt
./Wikipedia_disambiguation/Wikipedia_disambiguation27.txt	./Wikipedia_disambiguation/10 ans de succès.txt
./Wikipedia_disambiguation/Wikipedia_disambiguation28.txt	./Wikipedia_disambiguation/10 Days.txt
./Wikipedia_disambiguation/Wikipedia_disambiguation29.txt	./Wikipedia_disambiguation/10 dollar note.txt
./Wikipedia_disambiguation/Wikipedia_disambiguation30.txt	./Wikipedia_disambiguation/10 Great Songs.txt
./Wikipedia_disambiguation/Wikipedia_disambiguation31.txt	./Wikipedia_disambiguation/10 Items or Less.txt
./Wikipedia_disambiguation/Wikipedia_disambiguation32.txt	./Wikipedia_disambiguation/10 Magazine.txt
./Wikipedia_disambiguation/Wikipedia_disambiguation33.txt	./Wikipedia_disambiguation/10 Network.txt
./Wikipedia_disambiguation/Wikipedia_disambiguation34.txt	./Wikipedia_disambiguation/10 Play.txt
./Wikipedia_disambiguation/Wikipedia_disambiguation35.txt	./Wikipedia_disambiguation/10 series.txt
./Wikipedia_disambiguation/Wikipedia_disambiguation36.txt	./Wikipedia_disambiguation/10th Anniversary Album.txt
./Wikipedia_disambiguation/Wikipedia_disambiguation37.txt	./Wikipedia_disambiguation/10th Anniversary Show.txt
./Wikipedia_disambiguation/Wikipedia_disambiguation38.txt	./Wikipedia_disambiguation/10th Anniversary.txt
./Wikipedia_disambiguation/Wikipedia_disambiguation39.txt	./Wikipedia_disambiguation/10th Central Committee.txt
./Wikipedia_disambiguation/Wikipedia_disambiguation40.txt	./Wikipedia_disambiguation/10th Congress.txt
./Wikipedia_disambiguation/Wikipedia_disambiguation41.txt	./Wikipedia_disambiguation/10th meridian.txt
./Wikipedia_disambiguation/Wikipedia_disambiguation42.txt	./Wikipedia_disambiguation/10th Parachute Division.txt
./Wikipedia_disambiguation/Wikipedia_disambiguation43.txt	./Wikipedia_disambiguation/10th parallel.txt
./Wikipedia_disambiguation/Wikipedia_disambiguation44.txt	./Wikipedia_disambiguation/10th Rifle Division.txt
./Wikipedia_disambiguation/Wikipedia_disambiguation45.txt	./Wikipedia_disambiguation/10x.txt
./Wikipedia_disambiguation/Wikipedia_disambiguation46.txt	./Wikipedia_disambiguation/10 Years Later.txt
./Wikipedia_disambiguation/Wikipedia_disambiguation47.txt	./Wikipedia_disambiguation/10 years.txt
./Wikipedia_disambiguation/Wikipedia_disambiguation48.txt	./Wikipedia_disambiguation/10 Years Younger.txt
./Wikipedia_disambiguation/Wikipedia_disambiguation49.txt	./Wikipedia_disambiguation/10 złotych.txt
./Wikipedia_disambiguation/Wikipedia_disambiguation50.txt	./Wikipedia_disambiguation/11:11.txt
./Wikipedia_disambiguation/Wikipedia_disambiguation51.txt	./Wikipedia_disambiguation/11 Minutes.txt
./Wikipedia_disambiguation/Wikipedia_disambiguation52.txt	./Wikipedia_disambiguation/11th Anniversary Show.txt
./Wikipedia_disambiguation/Wikipedia_disambiguation53.txt	./Wikipedia_disambiguation/11th Central Committee.txt
./Wikipedia_disambiguation/Wikipedia_disambiguation54.txt	./Wikipedia_disambiguation/11th Congress.txt
./Wikipedia_disambiguation/Wikipedia_disambiguation55.txt	./Wikipedia_disambiguation/11th dimension.txt
./Wikipedia_disambiguation/Wikipedia_disambiguation56.txt	./Wikipedia_disambiguation/11th meridian.txt
./Wikipedia_disambiguation/Wikipedia_disambiguation57.txt	./Wikipedia_disambiguation/11th parallel.txt
./Wikipedia_disambiguation/Wikipedia_disambiguation58.txt	./Wikipedia_disambiguation/11th Rifle Division.txt
./Wikipedia_disambiguation/Wikipedia_disambiguation59.txt	./Wikipedia_disambiguation/11th Street.txt
./Wikipedia_disambiguation/Wikipedia_disambiguation60.txt	./Wikipedia_disambiguation/11 Train.txt
./Wikipedia_disambiguation/Wikipedia_disambiguation61.txt	./Wikipedia_disambiguation/12"_50 caliber gun.txt
./Wikipedia_disambiguation/Wikipedia_disambiguation62.txt	./Wikipedia_disambiguation/12:51.txt
./Wikipedia_disambiguation/Wikipedia_disambiguation63.txt	./Wikipedia_disambiguation/12_5.txt
./Wikipedia_disambiguation/Wikipedia_disambiguation64.txt	./Wikipedia_disambiguation/12 Classics.txt
./Wikipedia_disambiguation/Wikipedia_disambiguation65.txt	./Wikipedia_disambiguation/12 gauge.txt
./Wikipedia_disambiguation/Wikipedia_disambiguation66.txt	./Wikipedia_disambiguation/12-inch mortar.txt
./Wikipedia_disambiguation/Wikipedia_disambiguation67.txt	./Wikipedia_disambiguation/12" Mixes.txt
./Wikipedia_disambiguation/Wikipedia_disambiguation68.txt	./Wikipedia_disambiguation/12 o'clock.txt
./Wikipedia_disambiguation/Wikipedia_disambiguation69.txt	./Wikipedia_disambiguation/12 rating.txt
./Wikipedia_disambiguation/Wikipedia_disambiguation70.txt	./Wikipedia_disambiguation/12 Rounds.txt
./Wikipedia_disambiguation/Wikipedia_disambiguation71.txt	./Wikipedia_disambiguation/12 Songs of Christmas.txt
./Wikipedia_disambiguation/Wikipedia_disambiguation72.txt	./Wikipedia_disambiguation/12th Anniversary Show.txt
./Wikipedia_disambiguation/Wikipedia_disambiguation73.txt	./Wikipedia_disambiguation/12th Central Committee.txt
./Wikipedia_disambiguation/Wikipedia_disambiguation74.txt	./Wikipedia_disambiguation/12th Congress.txt
./Wikipedia_disambiguation/Wikipedia_disambiguation75.txt	./Wikipedia_disambiguation/12th Man.txt
./Wikipedia_disambiguation/Wikipedia_disambiguation76.txt	./Wikipedia_disambiguation/12th meridian.txt
./Wikipedia_disambiguation/Wikipedia_disambiguation77.txt	./Wikipedia_disambiguation/12th of Never.txt
./Wikipedia_disambiguation/Wikipedia_disambiguation78.txt	./Wikipedia_disambiguation/12th parallel.txt
./Wikipedia_disambiguation/Wikipedia_disambiguation79.txt	./Wikipedia_disambiguation/12th Street.txt
./Wikipedia_disambiguation/Wikipedia_disambiguation80.txt	./Wikipedia_disambiguation/12 Train.txt
./Wikipedia_disambiguation/Wikipedia_disambiguation81.txt	./Wikipedia_disambiguation/12-volt battery.txt
./Wikipedia_disambiguation/Wikipedia_disambiguation82.txt	./Wikipedia_disambiguation/12-volt outlet.txt
./Wikipedia_disambiguation/Wikipedia_disambiguation83.txt	./Wikipedia_disambiguation/13 Assassins.txt
./Wikipedia_disambiguation/Wikipedia_disambiguation84.txt	./Wikipedia_disambiguation/13 Candles.txt
./Wikipedia_disambiguation/Wikipedia_disambiguation85.txt	./Wikipedia_disambiguation/13 Hours.txt
./Wikipedia_disambiguation/Wikipedia_disambiguation86.txt	./Wikipedia_disambiguation/13th Anniversary Show.txt
./Wikipedia_disambiguation/Wikipedia_disambiguation87.txt	./Wikipedia_disambiguation/13th Central Committee.txt
./Wikipedia_disambiguation/Wikipedia_disambiguation88.txt	./Wikipedia_disambiguation/13th Congress.txt
./Wikipedia_disambiguation/Wikipedia_disambiguation89.txt	./Wikipedia_disambiguation/13th Dragoons.txt
./Wikipedia_disambiguation/Wikipedia_disambiguation90.txt	./Wikipedia_disambiguation/13th man.txt
./Wikipedia_disambiguation/Wikipedia_disambiguation91.txt	./Wikipedia_disambiguation/13th meridian.txt
./Wikipedia_disambiguation/Wikipedia_disambiguation92.txt	./Wikipedia_disambiguation/13th parallel.txt
./Wikipedia_disambiguation/Wikipedia_disambiguation93.txt	./Wikipedia_disambiguation/1:43.txt
./Wikipedia_disambiguation/Wikipedia_disambiguation94.txt	./Wikipedia_disambiguation/14 Days.txt
./Wikipedia_disambiguation/Wikipedia_disambiguation95.txt	./Wikipedia_disambiguation/14 inch gun.txt
./Wikipedia_disambiguation/Wikipedia_disambiguation96.txt	./Wikipedia_disambiguation/14 rating.txt
./Wikipedia_disambiguation/Wikipedia_disambiguation97.txt	./Wikipedia_disambiguation/14 Songs.txt
./Wikipedia_disambiguation/Wikipedia_disambiguation98.txt	./Wikipedia_disambiguation/14th Avenue.txt
./Wikipedia_disambiguation/Wikipedia_disambiguation99.txt	./Wikipedia_disambiguation/14th Central Committee.txt
./Wikipedia_disambiguation/Wikipedia_disambiguation100.txt	./Wikipedia_disambiguation/14th Congress.txt
./Wikipedia_disambiguation/Wikipedia_disambiguation101.txt	./Wikipedia_disambiguation/14th meridian.txt
./Wikipedia_disambiguation/Wikipedia_disambiguation102.txt	./Wikipedia_disambiguation/14th parallel.txt
./Wikipedia_disambiguation/Wikipedia_disambiguation103.txt	./Wikipedia_disambiguation/14th Street Bridge.txt
./Wikipedia_disambiguation/Wikipedia_disambiguation104.txt	./Wikipedia_disambiguation/14th Street Line.txt
./Wikipedia_disambiguation/Wikipedia_disambiguation105.txt	./Wikipedia_disambiguation/14th Street.txt
./Wikipedia_disambiguation/Wikipedia_disambiguation106.txt	./Wikipedia_disambiguation/14th Street Viaduct.txt
./Wikipedia_disambiguation/Wikipedia_disambiguation107.txt	./Wikipedia_disambiguation/15 Años.txt
./Wikipedia_disambiguation/Wikipedia_disambiguation108.txt	./Wikipedia_disambiguation/15 Days.txt
./Wikipedia_disambiguation/Wikipedia_disambiguation109.txt	./Wikipedia_disambiguation/15 Éxitos.txt
./Wikipedia_disambiguation/Wikipedia_disambiguation110.txt	./Wikipedia_disambiguation/15 Inolvidables (disambiguation).txt
./Wikipedia_disambiguation/Wikipedia_disambiguation111.txt	./Wikipedia_disambiguation/15 Minutes (disambiguation).txt
./Wikipedia_disambiguation/Wikipedia_disambiguation112.txt	./Wikipedia_disambiguation/15 pounder.txt
./Wikipedia_disambiguation/Wikipedia_disambiguation113.txt	./Wikipedia_disambiguation/15 rating.txt
./Wikipedia_disambiguation/Wikipedia_disambiguation114.txt	./Wikipedia_disambiguation/15 Songs.txt
./Wikipedia_disambiguation/Wikipedia_disambiguation115.txt	./Wikipedia_disambiguation/15th Central Committee.txt
./Wikipedia_disambiguation/Wikipedia_disambiguation116.txt	./Wikipedia_disambiguation/15th clan chief.txt
./Wikipedia_disambiguation/Wikipedia_disambiguation117.txt	./Wikipedia_disambiguation/15th Congress.txt
./Wikipedia_disambiguation/Wikipedia_disambiguation118.txt	./Wikipedia_disambiguation/15th meridian.txt
./Wikipedia_disambiguation/Wikipedia_disambiguation119.txt	./Wikipedia_disambiguation/15th parallel.txt
./Wikipedia_disambiguation/Wikipedia_disambiguation120.txt	./Wikipedia_disambiguation/15th Street.txt
./Wikipedia_disambiguation/Wikipedia_disambiguation121.txt	./Wikipedia_disambiguation/16-bit (disambiguation).txt
./Wikipedia_disambiguation/Wikipedia_disambiguation122.txt	./Wikipedia_disambiguation/16 Most Requested Songs.txt
./Wikipedia_disambiguation/Wikipedia_disambiguation123.txt	./Wikipedia_disambiguation/16 Songs.txt
./Wikipedia_disambiguation/Wikipedia_disambiguation124.txt	./Wikipedia_disambiguation/16th Central Committee.txt
./Wikipedia_disambiguation/Wikipedia_disambiguation125.txt	./Wikipedia_disambiguation/16th Congress.txt
./Wikipedia_disambiguation/Wikipedia_disambiguation126.txt	./Wikipedia_disambiguation/16th district.txt
./Wikipedia_disambiguation/Wikipedia_disambiguation127.txt	./Wikipedia_disambiguation/16th meridian.txt
./Wikipedia_disambiguation/Wikipedia_disambiguation128.txt	./Wikipedia_disambiguation/16th parallel.txt
./Wikipedia_disambiguation/Wikipedia_disambiguation129.txt	./Wikipedia_disambiguation/16th Street Bridge.txt
./Wikipedia_disambiguation/Wikipedia_disambiguation130.txt	./Wikipedia_disambiguation/16th Street.txt
./Wikipedia_disambiguation/Wikipedia_disambiguation131.txt	./Wikipedia_disambiguation/17 Again.txt
./Wikipedia_disambiguation/Wikipedia_disambiguation132.txt	./Wikipedia_disambiguation/17 Days.txt
./Wikipedia_disambiguation/Wikipedia_disambiguation133.txt	./Wikipedia_disambiguation/17 Songs.txt
./Wikipedia_disambiguation/Wikipedia_disambiguation134.txt	./Wikipedia_disambiguation/17th Central Committee.txt
./Wikipedia_disambiguation/Wikipedia_disambiguation135.txt	./Wikipedia_disambiguation/17th Congress.txt
./Wikipedia_disambiguation/Wikipedia_disambiguation136.txt	./Wikipedia_disambiguation/17th meridian.txt
./Wikipedia_disambiguation/Wikipedia_disambiguation137.txt	./Wikipedia_disambiguation/17th parallel.txt
./Wikipedia_disambiguation/Wikipedia_disambiguation138.txt	./Wikipedia_disambiguation/17th Party Congress.txt
./Wikipedia_disambiguation/Wikipedia_disambiguation139.txt	./Wikipedia_disambiguation/18 Greatest Hits.txt
./Wikipedia_disambiguation/Wikipedia_disambiguation140.txt	./Wikipedia_disambiguation/18 Songs.txt
./Wikipedia_disambiguation/Wikipedia_disambiguation141.txt	./Wikipedia_disambiguation/18th Central Committee.txt
./Wikipedia_disambiguation/Wikipedia_disambiguation142.txt	./Wikipedia_disambiguation/18th century (disambiguation).txt
./Wikipedia_disambiguation/Wikipedia_disambiguation143.txt	./Wikipedia_disambiguation/18th Congress.txt
./Wikipedia_disambiguation/Wikipedia_disambiguation144.txt	./Wikipedia_disambiguation/18th meridian.txt
./Wikipedia_disambiguation/Wikipedia_disambiguation145.txt	./Wikipedia_disambiguation/18th parallel.txt
./Wikipedia_disambiguation/Wikipedia_disambiguation146.txt	./Wikipedia_disambiguation/18 Wheeler.txt
./Wikipedia_disambiguation/Wikipedia_disambiguation147.txt	./Wikipedia_disambiguation/1-900 (disambiguation).txt
./Wikipedia_disambiguation/Wikipedia_disambiguation148.txt	./Wikipedia_disambiguation/19 Mayıs Stadium.txt
./Wikipedia_disambiguation/Wikipedia_disambiguation149.txt	./Wikipedia_disambiguation/19-Norandrostenediol.txt
./Wikipedia_disambiguation/Wikipedia_disambiguation150.txt	./Wikipedia_disambiguation/19-Norandrostenedione.txt
./Wikipedia_disambiguation/Wikipedia_disambiguation151.txt	./Wikipedia_disambiguation/19th century (disambiguation).txt
./Wikipedia_disambiguation/Wikipedia_disambiguation152.txt	./Wikipedia_disambiguation/19th Congress.txt
./Wikipedia_disambiguation/Wikipedia_disambiguation153.txt	./Wikipedia_disambiguation/19th meridian.txt
./Wikipedia_disambiguation/Wikipedia_disambiguation154.txt	./Wikipedia_disambiguation/19th parallel.txt
./Wikipedia_disambiguation/Wikipedia_disambiguation155.txt	./Wikipedia_disambiguation/1 ball.txt
./Wikipedia_disambiguation/Wikipedia_disambiguation156.txt	./Wikipedia_disambiguation/1-bit.txt
./Wikipedia_disambiguation/Wikipedia_disambiguation157.txt	./Wikipedia_disambiguation/1. deild karla.txt
./Wikipedia_disambiguation/Wikipedia_disambiguation158.txt	./Wikipedia_disambiguation/1. deild kvenna.txt
./Wikipedia_disambiguation/Wikipedia_disambiguation159.txt	./Wikipedia_disambiguation/1. Division.txt
./Wikipedia_disambiguation/Wikipedia_disambiguation160.txt	./Wikipedia_disambiguation/1. Liga.txt
./Wikipedia_disambiguation/Wikipedia_disambiguation161.txt	./Wikipedia_disambiguation/1 Litre of Tears.txt
./Wikipedia_disambiguation/Wikipedia_disambiguation162.txt	./Wikipedia_disambiguation/1º de Mayo.txt
./Wikipedia_disambiguation/Wikipedia_disambiguation163.txt	./Wikipedia_disambiguation/1 of 1.txt
./Wikipedia_disambiguation/Wikipedia_disambiguation164.txt	./Wikipedia_disambiguation/1º.txt
./Wikipedia_disambiguation/Wikipedia_disambiguation165.txt	./Wikipedia_disambiguation/1 series.txt
./Wikipedia_disambiguation/Wikipedia_disambiguation166.txt	./Wikipedia_disambiguation/1st &amp; Ten.txt
./Wikipedia_disambiguation/Wikipedia_disambiguation167.txt	./Wikipedia_disambiguation/1st Baron Redesdale.txt
./Wikipedia_disambiguation/Wikipedia_disambiguation168.txt	./Wikipedia_disambiguation/1st Central Committee.txt
./Wikipedia_disambiguation/Wikipedia_disambiguation169.txt	./Wikipedia_disambiguation/1st clan chief.txt
./Wikipedia_disambiguation/Wikipedia_disambiguation170.txt	./Wikipedia_disambiguation/1st Congress.txt
./Wikipedia_disambiguation/Wikipedia_disambiguation171.txt	./Wikipedia_disambiguation/1st district.txt
./Wikipedia_disambiguation/Wikipedia_disambiguation172.txt	./Wikipedia_disambiguation/1st Division.txt
./Wikipedia_disambiguation/Wikipedia_disambiguation173.txt	./Wikipedia_disambiguation/1st Duke of Buckingham.txt
./Wikipedia_disambiguation/Wikipedia_disambiguation174.txt	./Wikipedia_disambiguation/1st Duke of Lancaster.txt
./Wikipedia_disambiguation/Wikipedia_disambiguation175.txt	./Wikipedia_disambiguation/1st Duke of Newcastle.txt
./Wikipedia_disambiguation/Wikipedia_disambiguation176.txt	./Wikipedia_disambiguation/1st Earl of Clarendon.txt
./Wikipedia_disambiguation/Wikipedia_disambiguation177.txt	./Wikipedia_disambiguation/1st Earl of Derby.txt
./Wikipedia_disambiguation/Wikipedia_disambiguation178.txt	./Wikipedia_disambiguation/1st Earl of Liverpool.txt
./Wikipedia_disambiguation/Wikipedia_disambiguation179.txt	./Wikipedia_disambiguation/1st Earl of Orford.txt
./Wikipedia_disambiguation/Wikipedia_disambiguation180.txt	./Wikipedia_disambiguation/1st Earl of Shelburne.txt
./Wikipedia_disambiguation/Wikipedia_disambiguation181.txt	./Wikipedia_disambiguation/1st Earl of Suffolk.txt
./Wikipedia_disambiguation/Wikipedia_disambiguation182.txt	./Wikipedia_disambiguation/1st Earl Temple.txt
./Wikipedia_disambiguation/Wikipedia_disambiguation183.txt	./Wikipedia_disambiguation/1st Front.txt
./Wikipedia_disambiguation/Wikipedia_disambiguation184.txt	./Wikipedia_disambiguation/1st meridian.txt
./Wikipedia_disambiguation/Wikipedia_disambiguation185.txt	./Wikipedia_disambiguation/1st Moroccan Infantry Division.txt
./Wikipedia_disambiguation/Wikipedia_disambiguation186.txt	./Wikipedia_disambiguation/1st parallel.txt
./Wikipedia_disambiguation/Wikipedia_disambiguation187.txt	./Wikipedia_disambiguation/1st Rank Raju.txt
./Wikipedia_disambiguation/Wikipedia_disambiguation188.txt	./Wikipedia_disambiguation/1st Viscount Goderich.txt
./Wikipedia_disambiguation/Wikipedia_disambiguation189.txt	./Wikipedia_disambiguation/1st Viscount Hampden.txt
./Wikipedia_disambiguation/Wikipedia_disambiguation190.txt	./Wikipedia_disambiguation/1 Train.txt
./Wikipedia_disambiguation/Wikipedia_disambiguation191.txt	./Wikipedia_disambiguation/20,000 Leagues Under the Sea (disambiguation).txt
./Wikipedia_disambiguation/Wikipedia_disambiguation192.txt	./Wikipedia_disambiguation/20 Años.txt
./Wikipedia_disambiguation/Wikipedia_disambiguation193.txt	./Wikipedia_disambiguation/20 Cigarettes.txt
./Wikipedia_disambiguation/Wikipedia_disambiguation194.txt	./Wikipedia_disambiguation/20 De Colección.txt
./Wikipedia_disambiguation/Wikipedia_disambiguation195.txt	./Wikipedia_disambiguation/20 Golden Greats.txt
./Wikipedia_disambiguation/Wikipedia_disambiguation196.txt	./Wikipedia_disambiguation/20 Grandes Éxitos.txt
./Wikipedia_disambiguation/Wikipedia_disambiguation197.txt	./Wikipedia_disambiguation/20 Greatest Hits.txt
./Wikipedia_disambiguation/Wikipedia_disambiguation198.txt	./Wikipedia_disambiguation/20 Inolvidables.txt
./Wikipedia_disambiguation/Wikipedia_disambiguation199.txt	./Wikipedia_disambiguation/20 kilometres.txt
./Wikipedia_disambiguation/Wikipedia_disambiguation200.txt	./Wikipedia_disambiguation/20 minutes.txt
./Wikipedia_disambiguation/Wikipedia_disambiguation201.txt	./Wikipedia_disambiguation/20 of the Best.txt
./Wikipedia_disambiguation/Wikipedia_disambiguation202.txt	./Wikipedia_disambiguation/20 series.txt
./Wikipedia_disambiguation/Wikipedia_disambiguation203.txt	./Wikipedia_disambiguation/20th Anniversary Tour.txt
./Wikipedia_disambiguation/Wikipedia_disambiguation204.txt	./Wikipedia_disambiguation/20th Century Blues.txt
./Wikipedia_disambiguation/Wikipedia_disambiguation205.txt	./Wikipedia_disambiguation/20th century (disambiguation).txt
./Wikipedia_disambiguation/Wikipedia_disambiguation206.txt	./Wikipedia_disambiguation/20th Century Fox (disambiguation).txt
./Wikipedia_disambiguation/Wikipedia_disambiguation207.txt	./Wikipedia_disambiguation/20th century in fashion.txt
./Wikipedia_disambiguation/Wikipedia_disambiguation208.txt	./Wikipedia_disambiguation/20th Century Masters: The Christmas Collection.txt
./Wikipedia_disambiguation/Wikipedia_disambiguation209.txt	./Wikipedia_disambiguation/20th Congress.txt
./Wikipedia_disambiguation/Wikipedia_disambiguation210.txt	./Wikipedia_disambiguation/20th meridian.txt
./Wikipedia_disambiguation/Wikipedia_disambiguation211.txt	./Wikipedia_disambiguation/20th parallel.txt
./Wikipedia_disambiguation/Wikipedia_disambiguation212.txt	./Wikipedia_disambiguation/20th Street station.txt
./Wikipedia_disambiguation/Wikipedia_disambiguation213.txt	./Wikipedia_disambiguation/20th Street.txt
./Wikipedia_disambiguation/Wikipedia_disambiguation214.txt	./Wikipedia_disambiguation/2_0.txt
./Wikipedia_disambiguation/Wikipedia_disambiguation215.txt	./Wikipedia_disambiguation/20 Years.txt
./Wikipedia_disambiguation/Wikipedia_disambiguation216.txt	./Wikipedia_disambiguation/21 &amp; Over.txt
./Wikipedia_disambiguation/Wikipedia_disambiguation217.txt	./Wikipedia_disambiguation/21 Demands (disambiguation).txt
./Wikipedia_disambiguation/Wikipedia_disambiguation218.txt	./Wikipedia_disambiguation/21 Guns.txt
./Wikipedia_disambiguation/Wikipedia_disambiguation219.txt	./Wikipedia_disambiguation/21K.txt
./Wikipedia_disambiguation/Wikipedia_disambiguation220.txt	./Wikipedia_disambiguation/21st century (disambiguation).txt
./Wikipedia_disambiguation/Wikipedia_disambiguation221.txt	./Wikipedia_disambiguation/21st Century Fox (disambiguation).txt
./Wikipedia_disambiguation/Wikipedia_disambiguation222.txt	./Wikipedia_disambiguation/21st Century Girl.txt
./Wikipedia_disambiguation/Wikipedia_disambiguation223.txt	./Wikipedia_disambiguation/21st Congress.txt
./Wikipedia_disambiguation/Wikipedia_disambiguation224.txt	./Wikipedia_disambiguation/21st meridian.txt
./Wikipedia_disambiguation/Wikipedia_disambiguation225.txt	./Wikipedia_disambiguation/21st New Brunswick general election.txt
./Wikipedia_disambiguation/Wikipedia_disambiguation226.txt	./Wikipedia_disambiguation/21st Nova Scotia general election.txt
./Wikipedia_disambiguation/Wikipedia_disambiguation227.txt	./Wikipedia_disambiguation/21st parallel.txt
./Wikipedia_disambiguation/Wikipedia_disambiguation228.txt	./Wikipedia_disambiguation/2:22.txt
./Wikipedia_disambiguation/Wikipedia_disambiguation229.txt	./Wikipedia_disambiguation/22nd century (disambiguation).txt
./Wikipedia_disambiguation/Wikipedia_disambiguation230.txt	./Wikipedia_disambiguation/22nd meridian.txt
./Wikipedia_disambiguation/Wikipedia_disambiguation231.txt	./Wikipedia_disambiguation/22nd parallel.txt
./Wikipedia_disambiguation/Wikipedia_disambiguation232.txt	./Wikipedia_disambiguation/23 August (disambiguation).txt
./Wikipedia_disambiguation/Wikipedia_disambiguation233.txt	./Wikipedia_disambiguation/23rd meridian.txt
./Wikipedia_disambiguation/Wikipedia_disambiguation234.txt	./Wikipedia_disambiguation/23rd New Brunswick general election.txt
./Wikipedia_disambiguation/Wikipedia_disambiguation235.txt	./Wikipedia_disambiguation/23rd Nova Scotia general election.txt
./Wikipedia_disambiguation/Wikipedia_disambiguation236.txt	./Wikipedia_disambiguation/23rd parallel.txt
./Wikipedia_disambiguation/Wikipedia_disambiguation237.txt	./Wikipedia_disambiguation/23rd Street Ferry.txt
./Wikipedia_disambiguation/Wikipedia_disambiguation238.txt	./Wikipedia_disambiguation/23rd Street.txt
./Wikipedia_disambiguation/Wikipedia_disambiguation239.txt	./Wikipedia_disambiguation/23 skidoo.txt
./Wikipedia_disambiguation/Wikipedia_disambiguation240.txt	./Wikipedia_disambiguation/24-bit (disambiguation).txt
./Wikipedia_disambiguation/Wikipedia_disambiguation241.txt	./Wikipedia_disambiguation/24 Caprices.txt
./Wikipedia_disambiguation/Wikipedia_disambiguation242.txt	./Wikipedia_disambiguation/24 Carat Gold.txt
./Wikipedia_disambiguation/Wikipedia_disambiguation243.txt	./Wikipedia_disambiguation/24 Days (disambiguation).txt
./Wikipedia_disambiguation/Wikipedia_disambiguation244.txt	./Wikipedia_disambiguation/24fps.txt
./Wikipedia_disambiguation/Wikipedia_disambiguation245.txt	./Wikipedia_disambiguation/24 Frames.txt
./Wikipedia_disambiguation/Wikipedia_disambiguation246.txt	./Wikipedia_disambiguation/24 Heures.txt
./Wikipedia_disambiguation/Wikipedia_disambiguation247.txt	./Wikipedia_disambiguation/24 Horas.txt
./Wikipedia_disambiguation/Wikipedia_disambiguation248.txt	./Wikipedia_disambiguation/24-hour race.txt
./Wikipedia_disambiguation/Wikipedia_disambiguation249.txt	./Wikipedia_disambiguation/24 Hours a Day.txt
./Wikipedia_disambiguation/Wikipedia_disambiguation250.txt	./Wikipedia_disambiguation/24 Hours of Le Mans (disambiguation).txt
./Wikipedia_disambiguation/Wikipedia_disambiguation251.txt	./Wikipedia_disambiguation/24 Hours.txt
./Wikipedia_disambiguation/Wikipedia_disambiguation252.txt	./Wikipedia_disambiguation/24K Magic.txt
./Wikipedia_disambiguation/Wikipedia_disambiguation253.txt	./Wikipedia_disambiguation/24 sata.txt
./Wikipedia_disambiguation/Wikipedia_disambiguation254.txt	./Wikipedia_disambiguation/24th meridian.txt
./Wikipedia_disambiguation/Wikipedia_disambiguation255.txt	./Wikipedia_disambiguation/24th New Brunswick general election.txt
./Wikipedia_disambiguation/Wikipedia_disambiguation256.txt	./Wikipedia_disambiguation/24th Nova Scotia general election.txt
./Wikipedia_disambiguation/Wikipedia_disambiguation257.txt	./Wikipedia_disambiguation/24th parallel.txt
./Wikipedia_disambiguation/Wikipedia_disambiguation258.txt	./Wikipedia_disambiguation/25 Aniversario (disambiguation).txt
./Wikipedia_disambiguation/Wikipedia_disambiguation259.txt	./Wikipedia_disambiguation/25 Años.txt
./Wikipedia_disambiguation/Wikipedia_disambiguation260.txt	./Wikipedia_disambiguation/25 Hz Power Transmission System.txt
./Wikipedia_disambiguation/Wikipedia_disambiguation261.txt	./Wikipedia_disambiguation/25 km.txt
./Wikipedia_disambiguation/Wikipedia_disambiguation262.txt	./Wikipedia_disambiguation/25th Anniversary Collection.txt
./Wikipedia_disambiguation/Wikipedia_disambiguation263.txt	./Wikipedia_disambiguation/25th Anniversary.txt
./Wikipedia_disambiguation/Wikipedia_disambiguation264.txt	./Wikipedia_disambiguation/25th meridian.txt
./Wikipedia_disambiguation/Wikipedia_disambiguation265.txt	./Wikipedia_disambiguation/25th New Brunswick general election.txt
./Wikipedia_disambiguation/Wikipedia_disambiguation266.txt	./Wikipedia_disambiguation/25th Nova Scotia general election.txt
./Wikipedia_disambiguation/Wikipedia_disambiguation267.txt	./Wikipedia_disambiguation/25th parallel.txt
./Wikipedia_disambiguation/Wikipedia_disambiguation268.txt	./Wikipedia_disambiguation/25 Years.txt
./Wikipedia_disambiguation/Wikipedia_disambiguation269.txt	./Wikipedia_disambiguation/26A (disambiguation).txt
./Wikipedia_disambiguation/Wikipedia_disambiguation270.txt	./Wikipedia_disambiguation/26th meridian.txt
./Wikipedia_disambiguation/Wikipedia_disambiguation271.txt	./Wikipedia_disambiguation/26th New Brunswick general election.txt
./Wikipedia_disambiguation/Wikipedia_disambiguation272.txt	./Wikipedia_disambiguation/26th Nova Scotia general election.txt
./Wikipedia_disambiguation/Wikipedia_disambiguation273.txt	./Wikipedia_disambiguation/26th parallel.txt
./Wikipedia_disambiguation/Wikipedia_disambiguation274.txt	./Wikipedia_disambiguation/27A (disambiguation).txt
./Wikipedia_disambiguation/Wikipedia_disambiguation275.txt	./Wikipedia_disambiguation/27 km.txt
./Wikipedia_disambiguation/Wikipedia_disambiguation276.txt	./Wikipedia_disambiguation/27th meridian.txt
./Wikipedia_disambiguation/Wikipedia_disambiguation277.txt	./Wikipedia_disambiguation/27th New Brunswick general election.txt
./Wikipedia_disambiguation/Wikipedia_disambiguation278.txt	./Wikipedia_disambiguation/27th Nova Scotia general election.txt
./Wikipedia_disambiguation/Wikipedia_disambiguation279.txt	./Wikipedia_disambiguation/27th parallel.txt
./Wikipedia_disambiguation/Wikipedia_disambiguation280.txt	./Wikipedia_disambiguation/28 cm SK C naval gun.txt
./Wikipedia_disambiguation/Wikipedia_disambiguation281.txt	./Wikipedia_disambiguation/28 Days.txt
./Wikipedia_disambiguation/Wikipedia_disambiguation282.txt	./Wikipedia_disambiguation/28th meridian.txt
./Wikipedia_disambiguation/Wikipedia_disambiguation283.txt	./Wikipedia_disambiguation/28th New Brunswick general election.txt
./Wikipedia_disambiguation/Wikipedia_disambiguation284.txt	./Wikipedia_disambiguation/28th Nova Scotia general election.txt
./Wikipedia_disambiguation/Wikipedia_disambiguation285.txt	./Wikipedia_disambiguation/28th parallel.txt
./Wikipedia_disambiguation/Wikipedia_disambiguation286.txt	./Wikipedia_disambiguation/29th Infantry Brigade.txt
./Wikipedia_disambiguation/Wikipedia_disambiguation287.txt	./Wikipedia_disambiguation/29th meridian.txt
./Wikipedia_disambiguation/Wikipedia_disambiguation288.txt	./Wikipedia_disambiguation/29th New Brunswick general election.txt
./Wikipedia_disambiguation/Wikipedia_disambiguation289.txt	./Wikipedia_disambiguation/29th Nova Scotia general election.txt
./Wikipedia_disambiguation/Wikipedia_disambiguation290.txt	./Wikipedia_disambiguation/29th parallel.txt
./Wikipedia_disambiguation/Wikipedia_disambiguation291.txt	./Wikipedia_disambiguation/2-bit.txt
./Wikipedia_disambiguation/Wikipedia_disambiguation292.txt	./Wikipedia_disambiguation/2BU.txt
./Wikipedia_disambiguation/Wikipedia_disambiguation293.txt	./Wikipedia_disambiguation/2 cents.txt
./Wikipedia_disambiguation/Wikipedia_disambiguation294.txt	./Wikipedia_disambiguation/2-EHA.txt
./Wikipedia_disambiguation/Wikipedia_disambiguation295.txt	./Wikipedia_disambiguation/2-FA.txt
./Wikipedia_disambiguation/Wikipedia_disambiguation296.txt	./Wikipedia_disambiguation/2-graph.txt
./Wikipedia_disambiguation/Wikipedia_disambiguation297.txt	./Wikipedia_disambiguation/2. Liga.txt
./Wikipedia_disambiguation/Wikipedia_disambiguation298.txt	./Wikipedia_disambiguation/2nd Baron Redesdale.txt
./Wikipedia_disambiguation/Wikipedia_disambiguation299.txt	./Wikipedia_disambiguation/2nd Bundesliga.txt
./Wikipedia_disambiguation/Wikipedia_disambiguation300.txt	./Wikipedia_disambiguation/2nd Central Committee.txt
./Wikipedia_disambiguation/Wikipedia_disambiguation301.txt	./Wikipedia_disambiguation/2nd Congress.txt
./Wikipedia_disambiguation/Wikipedia_disambiguation302.txt	./Wikipedia_disambiguation/2nd district.txt
./Wikipedia_disambiguation/Wikipedia_disambiguation303.txt	./Wikipedia_disambiguation/2nd Duke of Buckingham.txt
./Wikipedia_disambiguation/Wikipedia_disambiguation304.txt	./Wikipedia_disambiguation/2nd Duke of Newcastle.txt
./Wikipedia_disambiguation/Wikipedia_disambiguation305.txt	./Wikipedia_disambiguation/2nd Duke of Norfolk.txt
./Wikipedia_disambiguation/Wikipedia_disambiguation306.txt	./Wikipedia_disambiguation/2nd Earl of Bristol.txt
./Wikipedia_disambiguation/Wikipedia_disambiguation307.txt	./Wikipedia_disambiguation/2nd Earl of Clarendon.txt
./Wikipedia_disambiguation/Wikipedia_disambiguation308.txt	./Wikipedia_disambiguation/2nd Earl of Derby.txt
./Wikipedia_disambiguation/Wikipedia_disambiguation309.txt	./Wikipedia_disambiguation/2nd Earl of Liverpool.txt
./Wikipedia_disambiguation/Wikipedia_disambiguation310.txt	./Wikipedia_disambiguation/2nd Earl of Orford.txt
./Wikipedia_disambiguation/Wikipedia_disambiguation311.txt	./Wikipedia_disambiguation/2nd Earl of Rochester.txt
./Wikipedia_disambiguation/Wikipedia_disambiguation312.txt	./Wikipedia_disambiguation/2nd Earl of Warwick.txt
./Wikipedia_disambiguation/Wikipedia_disambiguation313.txt	./Wikipedia_disambiguation/2nd Floor.txt
./Wikipedia_disambiguation/Wikipedia_disambiguation314.txt	./Wikipedia_disambiguation/2nd Front.txt
./Wikipedia_disambiguation/Wikipedia_disambiguation315.txt	./Wikipedia_disambiguation/2nd Kentucky Cavalry Regiment.txt
./Wikipedia_disambiguation/Wikipedia_disambiguation316.txt	./Wikipedia_disambiguation/2nd meridian.txt
./Wikipedia_disambiguation/Wikipedia_disambiguation317.txt	./Wikipedia_disambiguation/2nd Nikolskoye (disambiguation).txt
./Wikipedia_disambiguation/Wikipedia_disambiguation318.txt	./Wikipedia_disambiguation/2nd parallel.txt
./Wikipedia_disambiguation/Wikipedia_disambiguation319.txt	./Wikipedia_disambiguation/2nd Round.txt
./Wikipedia_disambiguation/Wikipedia_disambiguation320.txt	./Wikipedia_disambiguation/2nd Street.txt
./Wikipedia_disambiguation/Wikipedia_disambiguation321.txt	./Wikipedia_disambiguation/2 Train.txt
./Wikipedia_disambiguation/Wikipedia_disambiguation322.txt	./Wikipedia_disambiguation/−2.txt
./Wikipedia_disambiguation/Wikipedia_disambiguation323.txt	./Wikipedia_disambiguation/30 Aniversario (disambiguation).txt
./Wikipedia_disambiguation/Wikipedia_disambiguation324.txt	./Wikipedia_disambiguation/30 Años.txt
./Wikipedia_disambiguation/Wikipedia_disambiguation325.txt	./Wikipedia_disambiguation/30 Days of Night (disambiguation).txt
./Wikipedia_disambiguation/Wikipedia_disambiguation326.txt	./Wikipedia_disambiguation/3:10 to Yuma.txt
./Wikipedia_disambiguation/Wikipedia_disambiguation327.txt	./Wikipedia_disambiguation/3 A.M..txt
./Wikipedia_disambiguation/Wikipedia_disambiguation328.txt	./Wikipedia_disambiguation/3-coloring.txt
./Wikipedia_disambiguation/Wikipedia_disambiguation329.txt	./Wikipedia_disambiguation/3D camera.txt
./Wikipedia_disambiguation/Wikipedia_disambiguation330.txt	./Wikipedia_disambiguation/3D memory.txt
./Wikipedia_disambiguation/Wikipedia_disambiguation331.txt	./Wikipedia_disambiguation/3D Movie.txt
./Wikipedia_disambiguation/Wikipedia_disambiguation332.txt	./Wikipedia_disambiguation/3 Doors Down (disambiguation).txt
./Wikipedia_disambiguation/Wikipedia_disambiguation333.txt	./Wikipedia_disambiguation/3d studio.txt
./Wikipedia_disambiguation/Wikipedia_disambiguation334.txt	./Wikipedia_disambiguation/3D video game.txt
./Wikipedia_disambiguation/Wikipedia_disambiguation335.txt	./Wikipedia_disambiguation/3D Vision.txt
./Wikipedia_disambiguation/Wikipedia_disambiguation336.txt	./Wikipedia_disambiguation/3 Generations.txt
./Wikipedia_disambiguation/Wikipedia_disambiguation337.txt	./Wikipedia_disambiguation/3 lane road.txt
./Wikipedia_disambiguation/Wikipedia_disambiguation338.txt	./Wikipedia_disambiguation/3. Liga (disambiguation).txt
./Wikipedia_disambiguation/Wikipedia_disambiguation339.txt	./Wikipedia_disambiguation/3 Maja Street.txt
./Wikipedia_disambiguation/Wikipedia_disambiguation340.txt	./Wikipedia_disambiguation/3rd Central Committee.txt
./Wikipedia_disambiguation/Wikipedia_disambiguation341.txt	./Wikipedia_disambiguation/3rd Congress.txt
./Wikipedia_disambiguation/Wikipedia_disambiguation342.txt	./Wikipedia_disambiguation/3rd Duke of Buckingham.txt
./Wikipedia_disambiguation/Wikipedia_disambiguation343.txt	./Wikipedia_disambiguation/3rd Earl of Derby.txt
./Wikipedia_disambiguation/Wikipedia_disambiguation344.txt	./Wikipedia_disambiguation/3rd Earl of Orford.txt
./Wikipedia_disambiguation/Wikipedia_disambiguation345.txt	./Wikipedia_disambiguation/3rd Earl of Sussex.txt
./Wikipedia_disambiguation/Wikipedia_disambiguation346.txt	./Wikipedia_disambiguation/3rd meridian.txt
./Wikipedia_disambiguation/Wikipedia_disambiguation347.txt	./Wikipedia_disambiguation/3rd parallel.txt
./Wikipedia_disambiguation/Wikipedia_disambiguation348.txt	./Wikipedia_disambiguation/3rd Street Tunnel.txt
./Wikipedia_disambiguation/Wikipedia_disambiguation349.txt	./Wikipedia_disambiguation/3 Songs.txt
./Wikipedia_disambiguation/Wikipedia_disambiguation350.txt	./Wikipedia_disambiguation/3 Train.txt
./Wikipedia_disambiguation/Wikipedia_disambiguation351.txt	./Wikipedia_disambiguation/3-Way (disambiguation).txt
./Wikipedia_disambiguation/Wikipedia_disambiguation352.txt	./Wikipedia_disambiguation/4.2" mortar.txt
./Wikipedia_disambiguation/Wikipedia_disambiguation353.txt	./Wikipedia_disambiguation/4:44 (disambiguation).txt
./Wikipedia_disambiguation/Wikipedia_disambiguation354.txt	./Wikipedia_disambiguation/4-connected.txt
./Wikipedia_disambiguation/Wikipedia_disambiguation355.txt	./Wikipedia_disambiguation/4-cross.txt
./Wikipedia_disambiguation/Wikipedia_disambiguation356.txt	./Wikipedia_disambiguation/4 in Love.txt
./Wikipedia_disambiguation/Wikipedia_disambiguation357.txt	./Wikipedia_disambiguation/4. Liga.txt
./Wikipedia_disambiguation/Wikipedia_disambiguation358.txt	./Wikipedia_disambiguation/4 Minutes (disambiguation).txt
./Wikipedia_disambiguation/Wikipedia_disambiguation359.txt	./Wikipedia_disambiguation/4NT.txt
./Wikipedia_disambiguation/Wikipedia_disambiguation360.txt	./Wikipedia_disambiguation/4 Real (disambiguation).txt
./Wikipedia_disambiguation/Wikipedia_disambiguation361.txt	./Wikipedia_disambiguation/4th Central Committee.txt
./Wikipedia_disambiguation/Wikipedia_disambiguation362.txt	./Wikipedia_disambiguation/4th Congress.txt
./Wikipedia_disambiguation/Wikipedia_disambiguation363.txt	./Wikipedia_disambiguation/4th Earl of Clarendon.txt
./Wikipedia_disambiguation/Wikipedia_disambiguation364.txt	./Wikipedia_disambiguation/4th Earl of Derby.txt
./Wikipedia_disambiguation/Wikipedia_disambiguation365.txt	./Wikipedia_disambiguation/4th Earl of Orford.txt
./Wikipedia_disambiguation/Wikipedia_disambiguation366.txt	./Wikipedia_disambiguation/4th floor.txt
./Wikipedia_disambiguation/Wikipedia_disambiguation367.txt	./Wikipedia_disambiguation/4th meridian.txt
./Wikipedia_disambiguation/Wikipedia_disambiguation368.txt	./Wikipedia_disambiguation/4th Missouri Infantry Regiment.txt
./Wikipedia_disambiguation/Wikipedia_disambiguation369.txt	./Wikipedia_disambiguation/4th parallel.txt
./Wikipedia_disambiguation/Wikipedia_disambiguation370.txt	./Wikipedia_disambiguation/4-track.txt
./Wikipedia_disambiguation/Wikipedia_disambiguation371.txt	./Wikipedia_disambiguation/4 Train.txt
./Wikipedia_disambiguation/Wikipedia_disambiguation372.txt	./Wikipedia_disambiguation/4°.txt
./Wikipedia_disambiguation/Wikipedia_disambiguation373.txt	./Wikipedia_disambiguation/4-way.txt
./Wikipedia_disambiguation/Wikipedia_disambiguation374.txt	./Wikipedia_disambiguation/4x4 garage.txt
./Wikipedia_disambiguation/Wikipedia_disambiguation375.txt	./Wikipedia_disambiguation/5 o'clock.txt
./Wikipedia_disambiguation/Wikipedia_disambiguation376.txt	./Wikipedia_disambiguation/5 stages.txt
./Wikipedia_disambiguation/Wikipedia_disambiguation377.txt	./Wikipedia_disambiguation/5th Central Committee.txt
./Wikipedia_disambiguation/Wikipedia_disambiguation378.txt	./Wikipedia_disambiguation/5th Congress.txt
./Wikipedia_disambiguation/Wikipedia_disambiguation379.txt	./Wikipedia_disambiguation/5th Earl of Derby.txt
./Wikipedia_disambiguation/Wikipedia_disambiguation380.txt	./Wikipedia_disambiguation/5th Earl of Oxford.txt
./Wikipedia_disambiguation/Wikipedia_disambiguation381.txt	./Wikipedia_disambiguation/5th Gear.txt
./Wikipedia_disambiguation/Wikipedia_disambiguation382.txt	./Wikipedia_disambiguation/5th meridian.txt
./Wikipedia_disambiguation/Wikipedia_disambiguation383.txt	./Wikipedia_disambiguation/5th parallel.txt
./Wikipedia_disambiguation/Wikipedia_disambiguation384.txt	./Wikipedia_disambiguation/5th Street.txt
./Wikipedia_disambiguation/Wikipedia_disambiguation385.txt	./Wikipedia_disambiguation/5th Ward.txt
./Wikipedia_disambiguation/Wikipedia_disambiguation386.txt	./Wikipedia_disambiguation/5 Train.txt
./Wikipedia_disambiguation/Wikipedia_disambiguation387.txt	./Wikipedia_disambiguation/−5.txt
./Wikipedia_disambiguation/Wikipedia_disambiguation388.txt	./Wikipedia_disambiguation/6 Frigate.txt
./Wikipedia_disambiguation/Wikipedia_disambiguation389.txt	./Wikipedia_disambiguation/6 Kiss.txt
./Wikipedia_disambiguation/Wikipedia_disambiguation390.txt	./Wikipedia_disambiguation/6 meter.txt
./Wikipedia_disambiguation/Wikipedia_disambiguation391.txt	./Wikipedia_disambiguation/6 News.txt
./Wikipedia_disambiguation/Wikipedia_disambiguation392.txt	./Wikipedia_disambiguation/6th Central Committee.txt
./Wikipedia_disambiguation/Wikipedia_disambiguation393.txt	./Wikipedia_disambiguation/6th Congress.txt
./Wikipedia_disambiguation/Wikipedia_disambiguation394.txt	./Wikipedia_disambiguation/6th Earl of Derby.txt
./Wikipedia_disambiguation/Wikipedia_disambiguation395.txt	./Wikipedia_disambiguation/6th Massachusetts.txt
./Wikipedia_disambiguation/Wikipedia_disambiguation396.txt	./Wikipedia_disambiguation/6th meridian.txt
./Wikipedia_disambiguation/Wikipedia_disambiguation397.txt	./Wikipedia_disambiguation/6th Missouri Infantry Regiment.txt
./Wikipedia_disambiguation/Wikipedia_disambiguation398.txt	./Wikipedia_disambiguation/6th of October.txt
./Wikipedia_disambiguation/Wikipedia_disambiguation399.txt	./Wikipedia_disambiguation/6th parallel.txt
./Wikipedia_disambiguation/Wikipedia_disambiguation400.txt	./Wikipedia_disambiguation/6 Train.txt
./Wikipedia_disambiguation/Wikipedia_disambiguation401.txt	./Wikipedia_disambiguation/6 Underground.txt
./Wikipedia_disambiguation/Wikipedia_disambiguation402.txt	./Wikipedia_disambiguation/6-way.txt
./Wikipedia_disambiguation/Wikipedia_disambiguation403.txt	./Wikipedia_disambiguation/7:14.txt
./Wikipedia_disambiguation/Wikipedia_disambiguation404.txt	./Wikipedia_disambiguation/7 Billion.txt
./Wikipedia_disambiguation/Wikipedia_disambiguation405.txt	./Wikipedia_disambiguation/7-Eleven (disambiguation).txt
./Wikipedia_disambiguation/Wikipedia_disambiguation406.txt	./Wikipedia_disambiguation/7EP.txt
./Wikipedia_disambiguation/Wikipedia_disambiguation407.txt	./Wikipedia_disambiguation/7 Seconds.txt
./Wikipedia_disambiguation/Wikipedia_disambiguation408.txt	./Wikipedia_disambiguation/7 series.txt
./Wikipedia_disambiguation/Wikipedia_disambiguation409.txt	./Wikipedia_disambiguation/7th Cavalry.txt
./Wikipedia_disambiguation/Wikipedia_disambiguation410.txt	./Wikipedia_disambiguation/7th Central Committee.txt
./Wikipedia_disambiguation/Wikipedia_disambiguation411.txt	./Wikipedia_disambiguation/7th Congress.txt
./Wikipedia_disambiguation/Wikipedia_disambiguation412.txt	./Wikipedia_disambiguation/7th meridian.txt
./Wikipedia_disambiguation/Wikipedia_disambiguation413.txt	./Wikipedia_disambiguation/7th parallel.txt
./Wikipedia_disambiguation/Wikipedia_disambiguation414.txt	./Wikipedia_disambiguation/7th Sea.txt
./Wikipedia_disambiguation/Wikipedia_disambiguation415.txt	./Wikipedia_disambiguation/7th Signal Regiment.txt
./Wikipedia_disambiguation/Wikipedia_disambiguation416.txt	./Wikipedia_disambiguation/7th State.txt
./Wikipedia_disambiguation/Wikipedia_disambiguation417.txt	./Wikipedia_disambiguation/7th Street.txt
./Wikipedia_disambiguation/Wikipedia_disambiguation418.txt	./Wikipedia_disambiguation/7 Train.txt
./Wikipedia_disambiguation/Wikipedia_disambiguation419.txt	./Wikipedia_disambiguation/7 Up (disambiguation).txt
./Wikipedia_disambiguation/Wikipedia_disambiguation420.txt	./Wikipedia_disambiguation/8:46.txt
./Wikipedia_disambiguation/Wikipedia_disambiguation421.txt	./Wikipedia_disambiguation/8-bit (disambiguation).txt
./Wikipedia_disambiguation/Wikipedia_disambiguation422.txt	./Wikipedia_disambiguation/8 Days.txt
./Wikipedia_disambiguation/Wikipedia_disambiguation423.txt	./Wikipedia_disambiguation/8th Central Committee.txt
./Wikipedia_disambiguation/Wikipedia_disambiguation424.txt	./Wikipedia_disambiguation/8th congressional district.txt
./Wikipedia_disambiguation/Wikipedia_disambiguation425.txt	./Wikipedia_disambiguation/8th Congress.txt
./Wikipedia_disambiguation/Wikipedia_disambiguation426.txt	./Wikipedia_disambiguation/8th meridian.txt
./Wikipedia_disambiguation/Wikipedia_disambiguation427.txt	./Wikipedia_disambiguation/8th parallel.txt
./Wikipedia_disambiguation/Wikipedia_disambiguation428.txt	./Wikipedia_disambiguation/8-track.txt
./Wikipedia_disambiguation/Wikipedia_disambiguation429.txt	./Wikipedia_disambiguation/8-way.txt
./Wikipedia_disambiguation/Wikipedia_disambiguation430.txt	./Wikipedia_disambiguation/9×23mm.txt
./Wikipedia_disambiguation/Wikipedia_disambiguation431.txt	./Wikipedia_disambiguation/9 Fingers.txt
./Wikipedia_disambiguation/Wikipedia_disambiguation432.txt	./Wikipedia_disambiguation/9 September 1944 (disambiguation).txt
./Wikipedia_disambiguation/Wikipedia_disambiguation433.txt	./Wikipedia_disambiguation/9th Anniversary Show.txt
./Wikipedia_disambiguation/Wikipedia_disambiguation434.txt	./Wikipedia_disambiguation/9th Central Committee.txt
./Wikipedia_disambiguation/Wikipedia_disambiguation435.txt	./Wikipedia_disambiguation/9th Congress.txt
./Wikipedia_disambiguation/Wikipedia_disambiguation436.txt	./Wikipedia_disambiguation/9th Infantry Regiment.txt
./Wikipedia_disambiguation/Wikipedia_disambiguation437.txt	./Wikipedia_disambiguation/9th meridian.txt
./Wikipedia_disambiguation/Wikipedia_disambiguation438.txt	./Wikipedia_disambiguation/9th parallel.txt
./Wikipedia_disambiguation/Wikipedia_disambiguation439.txt	./Wikipedia_disambiguation/9 to 5 (disambiguation).txt
./Wikipedia_disambiguation/Wikipedia_disambiguation440.txt	./Wikipedia_disambiguation/&amp;&amp;.txt
./Wikipedia_disambiguation/Wikipedia_disambiguation441.txt	./Wikipedia_disambiguation/&amp; (disambiguation).txt
./Wikipedia_disambiguation/Wikipedia_disambiguation442.txt	./Wikipedia_disambiguation/(character).txt
./Wikipedia_disambiguation/Wikipedia_disambiguation443.txt	./Wikipedia_disambiguation/! (disambiguation).txt
./Wikipedia_disambiguation/Wikipedia_disambiguation444.txt	./Wikipedia_disambiguation/!!! (disambiguation).txt
./Wikipedia_disambiguation/Wikipedia_disambiguation445.txt	./Wikipedia_disambiguation/" (disambiguation).txt
./Wikipedia_disambiguation/Wikipedia_disambiguation446.txt	./Wikipedia_disambiguation/' (disambiguation).txt
./Wikipedia_disambiguation/Wikipedia_disambiguation447.txt	./Wikipedia_disambiguation/( ) (disambiguation).txt
./Wikipedia_disambiguation/Wikipedia_disambiguation448.txt	./Wikipedia_disambiguation/* (disambiguation).txt
./Wikipedia_disambiguation/Wikipedia_disambiguation449.txt	./Wikipedia_disambiguation/+ (disambiguation).txt
./Wikipedia_disambiguation/Wikipedia_disambiguation450.txt	./Wikipedia_disambiguation/- (disambiguation).txt
./Wikipedia_disambiguation/Wikipedia_disambiguation451.txt	./Wikipedia_disambiguation/¿Dónde está Elisa?.txt
./Wikipedia_disambiguation/Wikipedia_disambiguation452.txt	./Wikipedia_disambiguation/\nnn.txt
./Wikipedia_disambiguation/Wikipedia_disambiguation453.txt	./Wikipedia_disambiguation/¡Qué Chulada!.txt
./Wikipedia_disambiguation/Wikipedia_disambiguation454.txt	./Wikipedia_disambiguation/¿Quién es la máscara?.txt
./Wikipedia_disambiguation/Wikipedia_disambiguation455.txt	./Wikipedia_disambiguation/_s_.txt
./Wikipedia_disambiguation/Wikipedia_disambiguation456.txt	./Wikipedia_disambiguation/The 25th Hour (disambiguation).txt
./Wikipedia_disambiguation/Wikipedia_disambiguation457.txt	./Wikipedia_disambiguation/The 5th Wave.txt
./Wikipedia_disambiguation/Wikipedia_disambiguation458.txt	./Wikipedia_disambiguation/The 8th.txt
./Wikipedia_disambiguation/Wikipedia_disambiguation459.txt	./Wikipedia_disambiguation/'Til Kingdom Come.txt
./Wikipedia_disambiguation/Wikipedia_disambiguation460.txt	./Wikipedia_disambiguation/!!.txt
./Wikipedia_disambiguation/Wikipedia_disambiguation461.txt	./Wikipedia_disambiguation/(=.txt
./Wikipedia_disambiguation/Wikipedia_disambiguation462.txt	./Wikipedia_disambiguation/***.txt
./Wikipedia_disambiguation/Wikipedia_disambiguation463.txt	./Wikipedia_disambiguation/**.txt
./Wikipedia_disambiguation/Wikipedia_disambiguation464.txt	./Wikipedia_disambiguation/*=.txt
./Wikipedia_disambiguation/Wikipedia_disambiguation465.txt	./Wikipedia_disambiguation/+++.txt
./Wikipedia_disambiguation/Wikipedia_disambiguation466.txt	./Wikipedia_disambiguation/++.txt
./Wikipedia_disambiguation/Wikipedia_disambiguation467.txt	./Wikipedia_disambiguation/--.txt
./Wikipedia_disambiguation/Wikipedia_disambiguation468.txt	./Wikipedia_disambiguation/-.-.txt
./Wikipedia_disambiguation/Wikipedia_disambiguation469.txt	./Wikipedia_disambiguation/=?.txt
./Wikipedia_disambiguation/Wikipedia_disambiguation470.txt	./Wikipedia_disambiguation/?=.txt
./Wikipedia_disambiguation/Wikipedia_disambiguation471.txt	./Wikipedia_disambiguation/??.txt
./Wikipedia_disambiguation/Wikipedia_disambiguation472.txt	./Wikipedia_disambiguation/\\.txt
./Wikipedia_disambiguation/Wikipedia_disambiguation473.txt	./Wikipedia_disambiguation/\_.txt
./Wikipedia_disambiguation/Wikipedia_disambiguation474.txt	./Wikipedia_disambiguation/^^.txt
./Wikipedia_disambiguation/Wikipedia_disambiguation475.txt	./Wikipedia_disambiguation/_=.txt
./Wikipedia_disambiguation/Wikipedia_disambiguation476.txt	./Wikipedia_disambiguation/_\.txt
./Wikipedia_disambiguation/Wikipedia_disambiguation477.txt	./Wikipedia_disambiguation/__.txt
./Wikipedia_disambiguation/Wikipedia_disambiguation478.txt	./Wikipedia_disambiguation/←.txt
./Wikipedia_disambiguation/Wikipedia_disambiguation479.txt	./Wikipedia_disambiguation/↑.txt
./Wikipedia_disambiguation/Wikipedia_disambiguation480.txt	./Wikipedia_disambiguation/→.txt
./Wikipedia_disambiguation/Wikipedia_disambiguation481.txt	./Wikipedia_disambiguation/↓.txt
./Wikipedia_disambiguation/Wikipedia_disambiguation482.txt	./Wikipedia_disambiguation/∆.txt
./Wikipedia_disambiguation/Wikipedia_disambiguation483.txt	./Wikipedia_disambiguation/≡.txt
./Wikipedia_disambiguation/Wikipedia_disambiguation484.txt	./Wikipedia_disambiguation/≤.txt
./Wikipedia_disambiguation/Wikipedia_disambiguation485.txt	./Wikipedia_disambiguation/⊕.txt
./Wikipedia_disambiguation/Wikipedia_disambiguation486.txt	./Wikipedia_disambiguation/⊖.txt
./Wikipedia_disambiguation/Wikipedia_disambiguation487.txt	./Wikipedia_disambiguation/⊿.txt
./Wikipedia_disambiguation/Wikipedia_disambiguation488.txt	./Wikipedia_disambiguation/☨.txt
./Wikipedia_disambiguation/Wikipedia_disambiguation489.txt	./Wikipedia_disambiguation/✕.txt
./Wikipedia_disambiguation/Wikipedia_disambiguation490.txt	./Wikipedia_disambiguation/ּ.txt
